11111111111
1P000C000E1

10000000001
11111111111
