111111111
1P0C10001
111110001
100000011
110000011
1000000E1
111111111
