111110110
100E10110
1P0000010
1C0000C10
111111110
