11111011
100E1011
1P000001
1C0000C1
11111111
