1111111111
1c01000001
100100e001
1001000001
10100000p1
1111111111
1111111111
1111111111
