1111111111
1c01000001
100100e001
1001000001
101000001
11111111
