1111111111
1c01000001
100100e001
1001000001
1p01000001
1111111111
