111111111
1p0c10001
111110001
100000011
110000011
1000000e1
111111111
