1111111111
1c00000001
10001p0e01
1000000011
1000001001
1011011001
1111111111
