1111111111
1000000001
100p100001
1000000011
1000001001
10110110c1
1000011001
