1111111111
1c00000001
1000100e01
1000000011
1000001001
1p11011001
1111111111
