1111111111
1c00000001
100p100e01
1000000011
1000001001
1c11c110c1
1111111111
