1111111111
1C00000001
1000100E01
1000000011
1000001001
1P11011001
1111111111
